А	A
Ā	Ā
Б	B
В	V
W	W
Г	G
Д	D
Δ	Δ
ϴ	ϴ
Е	Ē
Ê	Ê
Ę	Ę
Ж	Ž
З	Z
И	I
Ӣ	Ī
Й	Y
К	K
Л	L
М	M
Н	N
О	Ō
Ǫ	Ǫ
П	P
Р	R
C	S
Т	T
У	U
Ӯ	Ū
Ӱ	Ü
Ф	F
X	X
Х	Х
Ц	C
Ȥ	Ȥ
Ч	Č
Ш	Š
Ғ	Г
Г	Г
Қ	Q
Ӽ	H
Ҷ	J
а	a
ā	ā
б	b
в	v
w	w
г	g
д	d
δ	δ
θ	θ
е	ē
ê	ê
ę	ę
ж	ž
з	z
и	i
ӣ	ī
й	y
к	k
л	l
м	m
н	n
о	ō
ǫ	ǫ
п	p
р	r
с	s
т	t
у	u
ӯ	ū
ӱ	ü
ф	f
x	x
х̌	х̌
ц	c
ȥ	ȥ
ч	č
ш	š
ғ	ɣ
ǯ	ǯ
қ	q
ӽ	h
ҷ	ǰ